11111111111111111111111111111111111111111111111111111111111111111111111111111111
10000001000001000001100000000110000000000001000000000000000001000000000000001001
10000000000011111001000000000011000000000011001000011100000001000000100000001001
10000110000110201011000111100011100000001110001000110000100011000000100000001001
10111100000000000001000000111110111000011000002000100000110010011111111001111001
10010000000000100001100000000100000000110000001000100000011110000000100000000001
10010000000000100000110000001100000000000000001100110000010011111000100000000001
10011000000000001100000000111000001000000011000000011100010000001000100111001111
10001000010000000100000000000000111000001110000010000000110001101000000000000001
10000000110000000000111000000001100011000100000110000001100000100000000000001001
10000001100001110000001100000001000001100110000000001100000000110001110000011001
10000111000000000000000100000000000011000011000000000110000010000000100100110001
11000102000000000011000001000000001110000001110000000010000011000000000020100011
10001100100100000001000001100000000011000011000000000000100000000000000011100001
10011000001110001100000000110000000001100110000010000000110000001110000110000001
10010000000000000100000110000001100000100011000110000000011100000000001100000001
10000000000000010110001100000001000001110000011100000000000000100000001000010001
11110011100100010000001000111000000011000000010000011100000000110000000000011001
10000000000100011111001000001100110000000000000000110000001100000100000000001001
10000000000100000001111000000100010000001100000000100000000110000100000000001001
10011110011111111001001100000100020000011000011101111100000010000000000000111101
10010000000100000011000100001100010001110000000111000111100011010001100001100001
10010000000100000010000000111000010011000000000011000000000010011111000000000001
10010000000000000010000000000000000010000000000001100000000110000010000010000001
11111111111111111111111111111111111111111111111111111111111111111111111111111111