11111111111111111111111111111111111111111111111111111111111111111111111111111111
10000000000000000000000000000000100000010000000000000000000000000000000000000001
11111111111111111100111111111111100000010000000000000000000000000000011111111111
10000000000000000100100000000000000000010000000000000000000000000000010000000001
10000000000000000100100000000000000000010000000011111111111110000000010000100001
10000010000000000000100000000000000000010000000000000001000000000000010000100001
10000010000000000000000000000000000000010000110100000001000000000000010000100001
10000010000000000000000000001111111111110000100100001111111111111111110000100001
10000010011111111100100000000000200000000000102100001000000000000000010000100001
10000010010000000000100000001111111111110000100100001000000000000000010000100001
10000010010000000000100000000000000000000000101100001000000000000000010000100001
10000010010000000000100000000000000000001000000000001000000001111111110000100001
10000000010000000000100000000000000000001000000000001000000000000000010000100001
10000000010000000000100000111111110000001111110000001000000000100000010000000001
11111111110000000000000000100000010000001000000000001000000000100020010000000001
10000000000000000000000000000020000000001000011111001000000000100000000000000001
10000000000000000000000000100000010000000000000001100000000000100000000000000001
10111111111111111111100000111111110000000001011000110000001000100000000001100001
10100000000000000000000000000000000000000001001100000000001000000000000000110001
10100000000000000000000000000000000000000001000111000000001000111111111000011101
10100000000000000111111111111110000000000001000000000000001000000000001000000101
12100000000000000000000000000010111111110001001111111111111000000000001000000101
11111111111111111100000000000010100000000001000000000000000000000000001000000101
10000000000000000000000000000010100000001111111100000000000000000000001000000101
11111111111111111111111111111111111111111111111111111111111111111111111111111111