11111111111111111111111111111111111111111111111111111111111111111111111111111111
10100000000000000000000000000000000000011000000000000000000002000000000000000101
10100000000000000000000000000000000000011000000000000000000000000000000010000101
10101111111111111111111000000000010000011000100000001111111111110000000000000001
10100000000010000000000000000000010000011000100000000000000000010000000000000101
10111111001010000000000000000000010000011000100000000100000000010000111111111101
10000000001010000000000000000000010000011000100000000000000000010000000000000101
10000111101010000001111111111110010000011000100001111111111110010000000000000101
10000000101010000001000000000000010000011000100000000000000010010000000000000101
10000010101010000001000000000000000000000000000000000100000010010000000000100101
10000010101000000001000000020000000000111111111000000100000010000000000000100101
10000010101000111111000000000002000000100000001000000100000011111100000000100101
10000010000000000000000000000000000000100020001000000100000000000000000000100001
10000010000000000000000011111111000000100000001000000100000000000000000000100001
10000011111110000000000000000000000111100000001000000101111111000000001111100001
10000000000000000000000000000000000000000000001000000000000000000000001000000001
10000000000111111111111110000000010000010001111000000001111111111111000000000001
10000200000000000000000010000000010000010000000000000000000000000001000000000001
10111111111111000000000010000000010000011100000000000000000000000001001111111001
10100000000000000000000010000000010000000000000000000000000000000001000000001001
10100001111111111111100010000000011111110000000000111111111111110001000000001001
10100000000000000000100010000000000000010000000000100000000000000001000000001001
10100000000000000000100010000000000000010000000000100000000000000001000000001001
10100000000000000000100010000000000000010000000000100000000000000001000000001001
11111111111111111111111111111111111111111111111111111111111111111111111111111111