11111111111111111111111111111111111111111111111111111111111111111111111111111111
10000000000000000000000000000000000000011000000000000000000000000000002000000101
10000000000000000000000000000000000000011000000000000000000000000000000000000101
10001111111111111111111000000000010000011000100000001111111111110000000002000001
10000000000010000000000000000000010000011000100000000000000000010000000000000101
10000000000010020000000000000000010000011000100000000000200000010000111111111101
10000000000010000000000000000000010000011000100000000000000000010000000000000101
10000000000010000001111111111110010000011000100001111111111110010000000000000101
10000000000010000001000000000000010000011000100000000000000010010000000000000101
10000000000010000001000000000000000000000000000000000000000010010000000000100101
10000000000000000001000000002000000000111111111000000000000010000000000000100101
10000000000000111111000000000000000000100000001000000000000011111100000000100101
10000000000000000000000000000000000000100200001000000000000000000000000000100001
10000000000000000000000011111111000000100000201000000000000000000000000000100001
10000200000000000000000000000000000111100000001000000000000000000000000111100001
10000000000000000000000000000000000000000000001000000000000000000000001100000001
10000000000111111111111110000000010000000001111000000001111111111111000000000001
10000000000000000000000010000000010000000000000000000000000000000001000000000001
10111111111111000000000010000000010000000000000000000000000000000001001111111001
10100000000000000000000010000000010000000000000000000000000000000001000000001001
10100001111111111111100010000000011111110000000000111111111111110001000000001001
10100000000000000000100010000000000000010000000000100000000000000001000000001001
10100000000000000000100010000000000020010000000000100000000000000001000002001001
10100000000000000000100010000000000000010000000000100000000000000001000000001001
11111111111111111111111111111111111111111111111111111111111111111111111111111111